sbr|devkont|cot-sbr|sbr
tiuorders|devkont|cot-tiuorders|tiuorders
marketorders|devkont|cot-marketorders|marketorders
prjsender|devkont|cot-prjsender|prjsender
yabilling|devkont|cot-yabilling|yabilling
ukarma|devkont|cot-ukarma|ukarma
payeerbilling|devkont|cot-payeerbilling|payeerbilling
logincheck|devkont|cot-logincheck|logincheck
catselector|devkont|cot-catselector|catselector
regpro|devkont|cot-regpro|regpro
qiwibilling|devkont|cot-qiwibilling||qiwibilling
paypalbilling|devkont|cot-paypal|paypalbilling
liqpaybilling|devkont|cot-liqpay|liqpaybilling
regpay|devkont|cot-regpay|regpay
easypay|devkont|cot-easypay|easypay
simprojects|devkont|cot-simprojects|simprojects
simproducts|devkont|cot-simproducts|simproducts
onliner|devkont|cot-onliner|onliner
projects|cmsworksru|cot-freelance|modules/projects
payments|cmsworksru|cot-freelance|modules/payments
market|cmsworksru|cot-freelance|modules/market
folio|cmsworksru|cot-freelance|modules/folio
autoalias2lance|cmsworksru|cot-freelance|plugins/autoalias2lance
usercategories|cmsworksru|cot-freelance|plugins/usercategories
ikassabilling|cmsworksru|cot-freelance|plugins/ikassabilling
locationselector|cmsworksru|cot-freelance|plugins/locationselector
mavatarslance|cmsworksru|cot-freelance|plugins/mavatarslance
payprjbold|cmsworksru|cot-freelance|plugins/payprjbold
payprjtop|cmsworksru|cot-freelance|plugins/payprjtop
paypro|cmsworksru|cot-freelance|plugins/paypro
paytop|cmsworksru|cot-freelance|plugins/paytop
reviews|cmsworksru|cot-freelance|plugins/reviews
roboxbilling|cmsworksru|cot-freelance|plugins/roboxbilling
tagslance|cmsworksru|cot-freelance|plugins/tagslance
useragreement|cmsworksru|cot-freelance|plugins/useragreement
usergroupselector|cmsworksru|cot-freelance|plugins/usergroupselector
userpoints|cmsworksru|cot-freelance|plugins/userpoints
wmbilling|cmsworksru|cot-freelance|plugins/wmbilling
countingusers|CrazyFreeMan|counting-users|countingusers
easycontact|CrazyFreeMan|easycontact|easycontact
loginza|CrazyFreeMan|cot-mloginzafl|loginza
filterforuser|CrazyFreeMan|cot-filterforuser|filterforuser